"filename", "language", "CSS", "HTML", "comment", "blank", "total"
"k:\Personal Projects\Bandit.Wargame.Walkthough\Levels\Level_0-0.html", "HTML", 0, 142, 0, 12, 154
"k:\Personal Projects\Bandit.Wargame.Walkthough\Levels\Level_0-1.html", "HTML", 0, 160, 0, 11, 171
"k:\Personal Projects\Bandit.Wargame.Walkthough\Levels\Level_1-2.html", "HTML", 0, 131, 0, 3, 134
"k:\Personal Projects\Bandit.Wargame.Walkthough\Levels\Level_10-11.html", "HTML", 0, 131, 0, 3, 134
"k:\Personal Projects\Bandit.Wargame.Walkthough\Levels\Level_11-12.html", "HTML", 0, 129, 0, 3, 132
"k:\Personal Projects\Bandit.Wargame.Walkthough\Levels\Level_12-13.html", "HTML", 0, 283, 0, 3, 286
"k:\Personal Projects\Bandit.Wargame.Walkthough\Levels\Level_13-14.html", "HTML", 0, 154, 0, 4, 158
"k:\Personal Projects\Bandit.Wargame.Walkthough\Levels\Level_14-15.html", "HTML", 0, 120, 0, 3, 123
"k:\Personal Projects\Bandit.Wargame.Walkthough\Levels\Level_15-16.html", "HTML", 0, 128, 0, 3, 131
"k:\Personal Projects\Bandit.Wargame.Walkthough\Levels\Level_16-17.html", "HTML", 0, 179, 0, 3, 182
"k:\Personal Projects\Bandit.Wargame.Walkthough\Levels\Level_17-18.html", "HTML", 0, 117, 0, 3, 120
"k:\Personal Projects\Bandit.Wargame.Walkthough\Levels\Level_18-19.html", "HTML", 0, 116, 0, 3, 119
"k:\Personal Projects\Bandit.Wargame.Walkthough\Levels\Level_19-20.html", "HTML", 0, 165, 0, 3, 168
"k:\Personal Projects\Bandit.Wargame.Walkthough\Levels\Level_2-3.html", "HTML", 0, 126, 0, 5, 131
"k:\Personal Projects\Bandit.Wargame.Walkthough\Levels\Level_20-21.html", "HTML", 0, 133, 0, 3, 136
"k:\Personal Projects\Bandit.Wargame.Walkthough\Levels\Level_21-22.html", "HTML", 0, 125, 0, 3, 128
"k:\Personal Projects\Bandit.Wargame.Walkthough\Levels\Level_22-23.html", "HTML", 0, 139, 0, 3, 142
"k:\Personal Projects\Bandit.Wargame.Walkthough\Levels\Level_23-24.html", "HTML", 0, 152, 0, 3, 155
"k:\Personal Projects\Bandit.Wargame.Walkthough\Levels\Level_24-25.html", "HTML", 0, 133, 0, 4, 137
"k:\Personal Projects\Bandit.Wargame.Walkthough\Levels\Level_25-26.html", "HTML", 0, 135, 0, 3, 138
"k:\Personal Projects\Bandit.Wargame.Walkthough\Levels\Level_26-27.html", "HTML", 0, 143, 0, 3, 146
"k:\Personal Projects\Bandit.Wargame.Walkthough\Levels\Level_27-28.html", "HTML", 0, 135, 0, 3, 138
"k:\Personal Projects\Bandit.Wargame.Walkthough\Levels\Level_28-29.html", "HTML", 0, 138, 0, 3, 141
"k:\Personal Projects\Bandit.Wargame.Walkthough\Levels\Level_29-30.html", "HTML", 0, 151, 0, 3, 154
"k:\Personal Projects\Bandit.Wargame.Walkthough\Levels\Level_3-4.html", "HTML", 0, 169, 0, 6, 175
"k:\Personal Projects\Bandit.Wargame.Walkthough\Levels\Level_30-31.html", "HTML", 0, 121, 0, 3, 124
"k:\Personal Projects\Bandit.Wargame.Walkthough\Levels\Level_4-5.html", "HTML", 0, 186, 0, 3, 189
"k:\Personal Projects\Bandit.Wargame.Walkthough\Levels\Level_5-6.html", "HTML", 0, 156, 0, 3, 159
"k:\Personal Projects\Bandit.Wargame.Walkthough\Levels\Level_6-7.html", "HTML", 0, 202, 0, 3, 205
"k:\Personal Projects\Bandit.Wargame.Walkthough\Levels\Level_7-8.html", "HTML", 0, 133, 0, 3, 136
"k:\Personal Projects\Bandit.Wargame.Walkthough\Levels\Level_8-9.html", "HTML", 0, 182, 0, 3, 185
"k:\Personal Projects\Bandit.Wargame.Walkthough\Levels\Level_9-10.html", "HTML", 0, 144, 0, 3, 147
"k:\Personal Projects\Bandit.Wargame.Walkthough\Levels\index.html", "HTML", 0, 75, 0, 3, 78
"k:\Personal Projects\Bandit.Wargame.Walkthough\Levels\style.css", "CSS", 116, 0, 0, 1, 117
"Total", "-", 116, 4833, 0, 124, 5073